TTTTTTTTT       TTTTTTTT
TTTTTTTT   X      TTTTTT
TTTTTTT            TTTTT
TTTTTT     G       TTTTT
TTTTTT         X   TTTTT
TTTTTTT  X         TTTTT
TTTTTTTT         TTTTTTT
TTTTTTTTT       TTTTTTTT
TTTTTTTTT   T    TTTTTTT
TTTTTTT     TTT   TTTTTT
TTTTTT  X  TTTTT   TTTTT
TTTTTT    TTTTTT    TTTT
TTTTT       TTTT     TTT
TTTTT    N          TTTT
TTTTT          X    TTTT
TTTTT             G TTTT
TTTTTT              TTTT
TTTTTTT            TTTTT
TTTTTTTTT         TTTTTT
TTTTTTTTTT   A  TTTTTTTT