TTTTTTTTT       TTTTTTTT
TTTTTTTT   X      TTTTTT
TTTTTTT            TTTTT
TTTTTT             TTTTT
TTTTTT      TT     TTTTT
TTTTT      TTT     TTTTT
TTTTT    G       TTTTTTT
TTTTTT          TTTTTTTT
TTTTTT     N   TTTTTTTTT
TTTTT          TTTTTTTTT
TTTTT           TTTTTTTT
TTTTT    X       TTTTTTT
TTTTTT          N TTTTTT
TTTTTTTTT          TTTTT
TTTTTTTTTT         TTTTT
TTTTTTTTTTTT       TTTTT
TTTTTTTTTTTT   N   TTTTT
TTTTTTTTTTT        TTTTT
TTTTTTTTTT        TTTTTT
TTTTTTTTTT   A  TTTTTTTT