TTTTTTTTT       TTTTTTTT
TTTTTTTT   X    TTTTTTTT
TTTTTTT          TTTTTTT
TTTTTT            TTTTTT
TTTTTT          N  TTTTT
TTTTT   G   TT     TTTTT
TTTTT      TTT    TTTTTT
TTTTTT           TTTTTTT
TTTTTT        X  TTTTTTT
TTTTT            TTTTTTT
TTTTT            TTTTTTT
TTTTT    X       TTTTTTT
TTTTTT            TTTTTT
TTTTTTTT           TTTTT
TTTTTTT    TT  X   TTTTT
TTTTT  N  TTT      TTTTT
TTTTT    TTT      TTTTTT
TTTTT          TTTTTTTTT
TTTTTT        TTTTTTTTT
TTTTTTTTTT   A  TTTTTTTT