TTTTT              TTTTT
TTTTT      X       TTTTT
TTTTTTT            TTTTT
TTTTTTTT           TTTTT
TTTTTTT       N   TTTTTT
TTTTTT           TTTTTTT
TTTTT             TTTTTT
TTTTT    TTXTT     TTTTT
TTTTT   TT   TT    TTTTT
TTTTT  TT  N  TTTTTTTTTT
TTTTT   TT   TT    TTTTT
TTTTT G  TT TT   X TTTTT
TTTTT   TT   TT    TTTTT
TTTTT  TT     TT   TTTTT
TTTTT              TTTTT
TTTTT              TTTTT
TTTTTT     X       TTTTT
TTTTTT            TTTTTT
TTTTTTT          TTTTTTT
TTTTTTTT    A   TTTTTTTT