TTTTTTTTT       TTTTTTTT
TTTTTTTT   X      TTTTTT
TTTTTTT            TTTTT
TTTTTT             TTTTT
TTTTTT     X   X   TTTTT
TTTTTTT            TTTTT
TTTTTTTT         TTTTTTT
TTTTTTTTTT      TTTTTTTT
TTTTTTTTT    N  TTTTTTTT
TTTTTTT          TTTTTTT
TTTTTT            TTTTTT
TTTTTT   X  TT     TTTTT
TTTTTTT     TT  N  TTTTT
TTTTTTT             TTTT
TTTTTTT             TTTT
TTTTTT X            TTTT
TTTTTT         N    TTTT
TTTTTTT            TTTTT
TTTTTTTTT         TTTTTT
TTTTTTTTTT   A  TTTTTTTT