TTTTTTTTT       TTTTTTTT
TTTTTTTT   X      TTTTTT
TTTTTTT            TTTTT
TTTTTT             TTTTT
TTTTTT         X   TTTTT
TTTTTTT  X         TTTTT
TTTTTTTT         TTTTTTT
TTTTTTTTT       TTTTTTTT
TTTTTTTTT   T    TTTTTTT
TTTTTTT     TTT   TTTTTT
TTTTTT     TTTTT   TTTTT
TTTTTT    TTTTTT    TTTT
TTTTT       TTTT     TTT
TTTTT    N          TTTT
TTTTT               TTTT
TTTTT               TTTT
TTTTTT              TTTT
TTTTTTT            TTTTT
TTTTTTTTT         TTTTTT
TTTTTTTTTT   A  TTTTTTTT