TTTTTTTTT       TTTTTTTT
TTTTTTTT   X      TTTTTT
TTTTTTT            TTTTT
TTTTTT             TTTTT
TTTTTT     TT  X   TTTTT
TTTTT      TT      TTTTT
TTTTT    G T     TTTTTTT
TTTTTT     T    TTTTTTTT
TTTTTT     T     TTTTTTT
TTTTT      T    TTTTTTTT
TTTTT           TTTTTTTT
TTTTT    X     TTTTTTTTT
TTTTTT        TTTTTTTTTT
TTTTTTTT      TTTTTTTTTT
TTTTTTT       TTTTTTTTTT
TTTTTT   N   TTTTTTTTTTT
TTTTTT        TTTTTTTTTT
TTTTTTT        TTTTTTTTT
TTTTTTTT       TTTTTTTTT
TTTTTTTTTT   A  TTTTTTTT