TTTTT              TTTTT
TTTTT    X         TTTTT
TTTTTTT       X    TTTTT
TTTTTTTTT          TTTTT
TTTTTTTT          TTTTTT
TTTTTT     N     TTTTTTT
TTTTT             TTTTTT
TTTTT   N  T   X  TTTTTT
TTTTTT     TT     TTTTTT
TTTTTTTT      G   TTTTTT
TTTTTTTT   TT    TTTTTTT
TTTTTTT    TT N  TTTTTTT
TTTTTTT  X  T     TTTTTT
TTTTTTT     T     TTTTTT
TTTTTT            TTTTTT
TTTTTTT     X     TTTTTT
TTTTTT             TTTTT
TTTTTTT   X   N   TTTTTT
TTTTTTT          TTTTTTT
TTTTTTTT    A   TTTTTTTT