TTTTTTTTT       TTTTTTTT
TTTTTTTT        TTTTTTTT
TTTTTTT    N     TTTTTTT
TTTTTT            TTTTTT
TTTTTT             TTTTT
TTTTT              TTTTT
TTTTT     TTT  N  TTTTTT
TTTTT     TTT    TTTTTTT
TTTTT G    TT  X TTTTTTT
TTTTT      TT    TTTTTTT
TTTTT X   TTT    TTTTTTT
TTTTT     TT     TTTTTTT
TTTTTT     TT     TTTTTT
TTTTTTTT   TTT     TTTTT
TTTTTTT    TTT     TTTTT
TTTTT      TT      TTTTT
TTTTT  X   T      TTTTTT
TTTTT            TTTTTTT
TTTTTT           TTTTTTT
TTTTTTTTTT   A  TTTTTTTT