TTTTTTTTT       TTTTTTTT
TTTTTTTT   X      TTTTTT
TTTTTTT            TTTTT
TTTTTT             TTTTT
TTTTTT         N   TTTTT
TTTTTTT            TTTTT
TTTTTTTT         TTTTTTT
TTTTTTTTT       TTTTTTTT
TTTTTTTTT   T    TTTTTTT
TTTTTTT     TTT   TTTTTT
TTTTTT     TTTTT   TTTTT
TTTTTT    TTTTTT    TTTT
TTTTT       TTTT     TTT
TTTTT             N TTTT
TTTTT               TTTT
TTTTT               TTTT
TTTTTT              TTTT
TTTTTTT            TTTTT
TTTTTTTTT         TTTTTT
TTTTTTTTTT   A  TTTTTTTT